1111111131
1111101101
1111100001
1111101111
1100001111
1101101111
1111121111