1111311101
1111011101
1100000011
1101101001
1001101111
1011101111
1211111111